32 32 32 32 32 32 32 32 32 43 44 42 43 32 54 38 50 53 40 32 32 32 32 32 32 32 32 32
32 32 32 32 32 64 64 32 32 32 32 32 32 32 32 32 32 32 32 32 32 32 32 32 32 32 32 32
32 32 32 32 32 32 32 32 32 32 32 32 32 32 32 32 32 32 32 32 32 32 32 32 32 32 32 32
28 04 04 04 04 04 04 04 04 04 04 04 04 21 20 04 04 04 04 04 04 04 04 04 04 04 04 29
07 34 34 34 34 34 34 34 34 34 34 34 34 02 03 34 34 34 34 34 34 34 34 34 34 34 34 06
07 34 12 01 01 13 34 12 01 01 01 13 34 02 03 34 12 01 01 01 13 34 12 01 01 13 34 06
07 35 02 32 32 03 34 02 32 32 32 03 34 02 03 34 02 32 32 32 03 34 02 32 32 03 35 06
07 34 14 00 00 15 34 14 00 00 00 15 34 14 15 34 14 00 00 00 15 34 14 00 00 15 34 06
07 34 34 34 34 34 34 34 34 34 34 34 34 34 34 34 34 34 34 34 34 34 34 34 34 34 34 06
07 34 12 01 01 13 34 12 13 34 12 01 01 01 01 01 01 13 34 12 13 34 12 01 01 13 34 06
07 34 14 00 00 15 34 02 03 34 14 00 00 13 12 00 00 15 34 02 03 34 14 00 00 15 34 06
07 34 34 34 34 34 34 02 03 34 34 34 34 02 03 34 34 34 34 02 03 34 34 34 34 34 34 06
30 05 05 05 05 25 34 02 14 01 01 13 32 02 03 32 12 01 01 15 03 34 24 05 05 05 05 31
32 32 32 32 32 07 34 02 12 00 00 15 32 14 15 32 14 00 00 13 03 34 06 32 32 32 32 32
32 32 32 32 32 07 34 02 03 32 32 32 32 32 32 32 32 32 32 02 03 34 06 32 32 32 32 32
32 32 32 32 32 07 34 02 03 32 08 05 05 33 33 05 05 09 32 02 03 34 06 32 32 32 32 32
04 04 04 04 04 27 34 14 15 32 06 32 32 32 32 32 32 07 32 14 15 34 26 04 04 04 04 04
32 32 32 32 32 32 34 32 32 32 06 32 32 32 32 32 32 07 32 32 32 34 32 32 32 32 32 32
05 05 05 05 05 25 34 12 13 32 06 32 32 32 32 32 32 07 32 12 13 34 24 05 05 05 05 05
32 32 32 32 32 07 34 02 03 32 10 04 04 04 04 04 04 11 32 02 03 34 06 32 32 32 32 32
32 32 32 32 32 07 34 02 03 32 32 53 40 36 39 60 62 32 32 02 03 34 06 32 32 32 32 32
32 32 32 32 32 07 34 02 03 32 12 01 01 01 01 01 01 13 32 02 03 34 06 32 32 32 32 32
28 04 04 04 04 27 34 14 15 32 14 00 00 13 12 00 00 15 32 14 15 34 26 04 04 04 04 29
07 34 34 34 34 34 34 34 34 34 34 34 34 02 03 34 34 34 34 34 34 34 34 34 34 34 34 06
07 34 12 01 01 13 34 12 01 01 01 13 34 02 03 34 12 01 01 01 13 34 12 01 01 13 34 06
07 34 14 00 13 03 34 14 00 00 00 15 34 14 15 34 14 00 00 00 15 34 02 12 00 15 34 06
07 35 34 34 02 03 34 34 34 34 34 34 34 32 32 34 34 34 34 34 34 34 02 03 34 34 35 06
18 01 13 34 02 03 34 12 13 34 12 01 01 01 01 01 01 13 34 12 13 34 02 03 34 12 01 19
16 00 15 34 14 15 34 02 03 34 14 00 00 13 12 00 00 15 34 02 03 34 14 15 34 14 00 17
07 34 34 34 34 34 34 02 03 34 34 34 34 02 03 34 34 34 34 02 03 34 34 34 34 34 34 06
07 34 12 01 01 01 01 15 14 01 01 13 34 02 03 34 12 01 01 15 14 01 01 01 01 13 34 06
07 34 14 00 00 00 00 00 00 00 00 15 34 14 15 34 14 00 00 00 00 00 00 00 00 15 34 06
07 34 34 34 34 34 34 34 34 34 34 34 34 34 34 34 34 34 34 34 34 34 34 34 34 34 34 06
30 05 05 05 05 05 05 05 05 05 05 05 05 05 05 05 05 05 05 05 05 05 05 05 05 05 05 31
32 32 32 32 32 32 32 32 32 32 32 32 32 32 32 32 32 32 32 32 32 32 32 32 32 32 32 32
32 32 32 32 32 32 32 32 32 32 32 32 32 32 32 32 32 32 32 32 32 32 32 32 32 32 32 32
